%%%%%%%%%%%%%%%%%%%%
%o...%........%...o%
%.%%.%.%%..%%.%.%%.%
%.%.....%..%.....%.%
%.%.%%.%%  %%.%%.%.%
%.....GGGGGG%.%....%
%.%...G%%%%%%.%..%.%
%.%...G%  oo%.%..%.%
%.%..G.% %%%%.%..%.%
%.%......G....%..%.%
%.%%.%.%%%%%%.%.%%.%
%o...%...P....%...o%
%%%%%%%%%%%%%%%%%%%%
